180
8
22 04 00 00 00 00 00 00 00 00 00 00 00 00 00 00 00 00 00 00 00 00 00 00 00 00 00 00 00 00 00 00 00 00 00 00 00 00 00 00 00 00 00 03 22 22 22 22 22 22 22 22 22 22 22 22 22 22 22 22 22 22 22 22 22 22 22 22 22 22 22 22 22 22 22 22 04 00 00 00 00 00 00 00 00 00 00 00 00 00 00 03 22 22 22 22 22 22 04 00 00 00 00 00 00 00 00 00 00 00 00 00 00 00 00 00 00 00 00 00 00 00 00 00 00 00 00 00 00 00 00 00 00 00 00 00 00 00 00 00 00 00 00 00 00 00 00 00 00 00 03 22 22 22 22 22 22 22 22 22 22 22 22 04 00 00 00 03 22 22 22 22 22 22 22 22 22 22 22 22
22 04 00 00 00 00 00 00 00 00 00 00 00 00 00 00 00 00 00 00 00 00 00 00 00 00 00 00 00 00 00 00 00 00 00 00 00 00 00 00 00 00 00 00 18 22 22 22 22 22 22 22 22 22 22 22 22 22 22 22 22 19 17 17 17 17 17 17 17 17 17 18 22 22 22 22 04 00 00 00 00 00 00 00 00 00 00 00 00 00 00 00 18 22 22 22 22 22 04 00 00 00 00 00 00 00 00 00 00 00 00 00 00 00 00 00 00 00 00 00 00 00 00 00 00 00 00 00 00 00 00 00 00 00 00 00 00 00 00 00 00 00 00 00 00 00 00 00 00 00 03 22 22 22 22 22 22 22 22 22 22 22 22 04 00 00 00 03 22 22 19 17 17 17 17 17 17 17 18 22 
22 04 00 00 00 00 00 00 00 00 00 00 13 00 00 00 00 00 14 00 00 00 00 00 00 00 00 00 00 00 00 00 00 00 00 00 00 00 00 00 10 00 00 00 00 17 17 17 18 22 22 22 22 22 22 22 22 22 22 22 22 04 00 00 00 00 00 00 00 00 00 00 17 18 22 22 04 00 00 00 00 00 00 00 00 00 00 00 00 00 00 00 00 18 22 22 22 22 04 00 00 00 00 00 00 00 00 00 00 09 00 00 00 00 00 00 00 00 00 00 00 00 00 00 00 00 00 00 00 00 00 00 00 00 00 00 00 00 00 00 00 00 00 00 00 00 00 00 00 00 03 22 22 22 22 22 19 17 17 17 19 22 22 04 00 00 00 03 22 22 04 00 00 00 00 00 00 00 03 22 
22 04 00 00 00 00 00 00 00 00 00 00 00 00 00 09 00 00 00 00 00 00 00 00 00 00 00 00 00 00 00 00 00 00 10 00 00 00 00 23 25 00 00 00 00 00 00 00 00 17 17 18 22 22 22 22 22 22 22 22 19 00 00 10 00 11 00 00 00 00 00 00 00 00 17 17 00 00 00 00 09 00 00 00 00 01 21 02 00 00 00 00 00 00 18 22 22 19 00 00 00 00 00 00 00 23 25 00 00 23 25 00 00 00 00 00 00 00 23 25 00 00 00 00 10 00 00 00 00 00 00 00 00 00 00 00 00 00 00 00 01 21 02 01 21 02 01 21 02 00 00 17 17 18 22 19 00 00 00 10 00 17 17 00 00 00 00 03 22 22 04 00 00 00 00 00 00 00 03 22 
22 04 00 00 00 12 00 00 00 00 00 00 11 01 21 21 02 00 00 00 00 00 00 01 21 02 00 15 00 00 00 00 00 23 25 00 00 00 00 00 00 00 00 00 00 09 11 00 00 00 16 00 17 17 17 17 17 17 17 17 00 00 01 21 21 21 02 00 00 00 00 00 00 00 00 00 00 00 00 00 23 24 25 00 00 03 22 04 00 00 00 00 00 00 00 17 17 00 00 00 00 00 09 00 00 00 00 00 00 00 00 00 00 00 00 09 11 00 00 00 00 00 00 00 23 25 00 00 00 00 00 00 00 00 01 21 02 00 00 00 03 22 04 03 22 04 03 22 04 00 00 00 00 00 17 00 00 00 23 25 00 00 00 00 00 09 00 00 17 17 00 00 00 00 00 00 00 00 03 22 
22 04 00 00 00 00 00 00 00 00 01 21 21 21 06 22 04 00 00 00 00 00 10 03 22 04 00 00 00 00 11 00 00 00 00 00 00 11 00 00 00 00 00 01 21 21 21 21 02 00 00 00 00 09 00 00 00 00 09 00 00 00 03 22 22 22 04 00 00 00 00 00 00 00 00 00 00 00 00 00 00 00 00 00 00 03 22 04 00 00 00 00 00 00 00 00 00 00 00 00 00 23 25 00 00 00 00 00 00 00 00 00 00 00 23 24 25 00 00 00 00 00 00 00 00 00 00 00 00 00 00 00 00 00 03 22 04 01 21 02 03 22 04 03 22 04 03 22 04 00 00 01 21 02 11 00 00 00 00 00 00 00 11 00 00 23 25 00 00 00 00 00 00 00 00 00 00 00 03 22 
22 04 09 00 10 00 00 00 00 11 03 22 22 22 22 22 04 00 00 00 01 21 21 21 22 04 00 00 09 01 21 21 02 00 09 01 21 21 02 00 00 00 00 03 22 22 22 22 04 10 00 00 01 21 02 00 00 01 21 02 11 01 21 22 22 22 04 00 00 00 00 00 00 00 09 00 00 10 09 00 00 11 00 00 01 21 05 21 02 09 00 11 10 00 01 21 21 02 00 00 00 00 00 00 00 00 00 00 00 00 00 00 00 00 00 00 00 00 00 00 00 00 00 00 00 00 00 00 00 00 01 21 02 09 03 22 04 03 22 04 03 22 04 03 22 04 03 22 04 00 01 21 22 21 21 21 02 00 11 08 00 01 21 21 02 00 00 00 00 00 00 00 10 11 00 00 09 00 03 22 
05 21 21 21 21 21 21 21 21 21 21 06 22 22 22 22 04 00 00 00 03 22 22 22 22 21 21 21 21 21 06 05 21 21 21 21 06 22 04 00 00 00 00 03 22 22 22 05 21 21 21 21 21 21 21 21 21 21 21 21 21 21 22 22 22 22 04 00 00 00 00 01 21 21 21 21 21 21 21 21 21 21 21 21 21 06 22 05 21 21 21 21 21 21 21 22 22 21 02 00 00 00 00 00 00 00 00 00 00 00 00 00 00 00 00 00 00 00 00 00 00 00 00 00 00 00 00 00 01 21 21 22 21 21 21 22 04 03 22 04 03 22 04 03 22 04 03 22 04 01 21 22 22 22 22 22 21 21 21 21 21 21 22 22 04 00 00 01 21 21 21 21 21 21 21 21 21 21 21 06 

